
111111011111010111110111111
111111011111010111110111111
111111011111010111110111111
000000000000000000000000000
111111111111010111111111111
000000000000000000000000000
111111011111010111110111111
111111011111010111110111111
111111011111010111110111111
111111011112010111110111111
000000000000000000000000000
111111111111010111111111111
000000000000000000000000000
111111011111010111110111111
111111011111010111110111111
111111011111010111110111111
111111011111010111110111111
111111011111010111110111111
111111011111010111110111111
111111011111010111110111111
000000000000000000000000000
111111111111010111111111111
000000000000000000000000000
111111011111010111110111111
111111011111010111110111111
111111011111010111110111111
111111011111010111110111111
111111011111010111110111111
